type octile
height 11
width 15
map
...............
...TTT...TTT...
...............
...TTT...TTT...
...............
...TTT...TTT...
...............
...TTT...TTT...
...............
...TTT...TTT...
...............